
	
せいよしゅう	青豫州	地名	
きょしょう	許昌	地名	
じゅしゅん	寿春	地名	
しょうけん	ショウ県	地名	
ぼくよう	濮陽	地名	
えいせん	潁川	地名	
かひ	下ヒ	地名	
ちんりゅう	陳留	地名	
じょなん	汝南	地名	
せきてい	石亭	地名	
ごうひ	合肥	地名	
がっぴ	合肥	地名	
たいざん	泰山	地名	
しょうはい	小沛	地名	
ほうじょう	彭城	地名	
ろこう	蘆江	地名	
じゅしゅこう	濡須口	地名	
わいいん	淮陰	地名	
こうりょう	広陵	地名	
ほうらい	蓬莱	地名	
ろうや	琅ヤ	地名	
じょうよう	襄陽	地名
こうりょう	江陵	地名
ちょうさ	長沙	地名
こうか	江夏	地名
けんぎょう	建業	地名
けんあん	建安	地名
こうし	交趾	地名
こうち	交趾	地名
いりょう	夷陵	地名
ぶりょう	武陵	地名
えいあん	永安	地名
れいりょう	零陵	地名
ばくじょう	麦城	地名
けいよう	桂陽	地名
こうよう	衡陽	地名
しんや	新野	地名
よしょう	豫章	地名
かよう	華容	地名
さいそう	柴桑	地名
そうご	蒼梧	地名
きょくあ	曲阿	地名
ごぐん	呉郡	地名
りんかい	臨海	地名
かいけい	会稽	地名
ちょうあん	長安	地名
ちんそう	陳倉	地名
けんかく	剣閣	地名
ふりょう	フ陵	地名
せいと	成都	地名
せいへい	西平	地名
ぶい	武威	地名
がいてい	街亭	地名
ごじょうげん	五丈原	地名
ふふう	扶風	地名
てんすい	天水	地名
あんてい	安定	地名
ぶと	武都	地名
きざん	岐山	地名
めんちくかん	綿竹関	地名
しとう	梓潼	地名
かんか	漢嘉	地名
けんねい	建寧	地名
こうしゅう	江州	地名
えいしょう	永昌	地名
うんなん	雲南	地名
こうこ	興古	地名
らくよう	洛陽	地名
かんちゅう	漢中	地名
じょうよう	上庸	地名
かんこくかん	函谷関	地名
ぶせき	武関	地名
しすいかん	汜水関	地名
ころうかん	虎牢関	地名
かざん	崋山	地名
せいじょう	西城	地名
かとう	河東	地名
どうかん	潼関	地名
けいよう	ケイ陽	地名
こうのう	弘農	地名
かだい	河内	地名
えんじょう	宛城	地名
はんじょう	樊城	地名
すうざん	嵩山	地名
ろよう	魯陽	地名
